# Here's commonly used abbreviations at the TUM School of Management:
- SoM = School of Management
- MGT = Managament
- UPE = Undergraduate Program Education PM = Program Management / Program Manager
- PC = Program Coordinator
- GM = Grade Management
- IO = International Office
- BMT = Bachelor in Management and Technology = TUM BWL
- BSMT = Bachelor in Sustainable Management and Technology
- MMT = Master in Management and Technology = TUM BWL Master
- MiM = Master in Management
- MCS = Master in Consumer Science
- MMDT = Master in Management and Digital Technology
- FIM = Master in Finance and Information Management
- MSMT = Master in Sustainable Management and Technology
- MiMI = Master in Management and Innovation
- MMDT – Master in Management and Digital Technology
- JIP = Joint International Program
- EEP = Entrepreneurship Exchange Program
- STEP = Sustainable Transitions Exchange Program
- HEC = Grand École des Hautes Études Commerciales
- DTU = Denmarks Tekniske Universitet
- EMBA = Executive MBA
- BIT = Executive MBA in Business & IT
- IBC = Executive MBA in Innovation & Business Creation
- CST = Center for Study and Teaching
- APSO = Allgemeinen Prüfungs- und Studienordnung = General Academic and Examination Regulations
- FPSO = Fachspezifischen Prüfungs- und Studienordnung = Program-specific Academic and Examination Regulations
- WTW = wirtschaftswissenschaftlich-technischen Wahlbereich
- (A)IE = (Advanced) International Experience
- PS = Project Studies = Projektstudium
- GOP = Grundlagen- und Orientierungsprüfung
- SFK = Studienfortschrittskontrolle
- NPV = Noten- und Prüfungsverwaltung
- PA = Prüfungsausschuss
- PAU = Prüfungsausschuss
- SH = Student Hub
- MUC = Munich
- HN = Heilbronn
- VDASA = Vice Dean of Academic and Student Affairs
- E&P = Economics & Policy
- F&A = Finance & Accounting
- I&E = Innovation & Entrepreneurship
- MSL = Marketing, Strategy & Leadership
- OT = Operations & Technology

# Here's the different study programs that the TUM School of Management offers:
- Bachelor in Management & Technology (BMT) features courses in management studies as well as in natural sciences or engineering. We also call it TUM-BWL. It is available in Munich and Heilbronn campus.
- Master in Management & Technology (MMT): consecutive to BMT
- Master in Management & Digital Technology (MMDT) (Heilbronn): is the ideal blend of management, informatics, and technology.
- Master in Management (MiM): is aimed exclusively at engineers and natural scientists who want to receive a wide range of skills in management, law, economics and business. Also available at TUM Campus Heilbronn.
- Master in Consumer Science (MCS): is a truly interdisciplinary program that offers you a combination of management studies with social and consumer sciences. Students choosing this program usually have academic backgrounds in management, economics, sociology or psychology.
- Master in Finance & Information Management (FIM): In the Finance and Information Management (FIM) master's program, students learn how to push digital technologies in finance forward and how to deal with Big Data by integrating technologies.
- Bachelor in Sustainable Management & Technology (BSMT) (Straubing): aims to provide students with basic business knowledge for developing sustainable technologies, products, and processes. Coupled with interdisciplinary and social skills, the aim is to enable our students to support the change towards sustainable companies.
- Master in Sustainable Management & Technology (MSMT) (Straubing): By focusing on sustainability in entrepreneurial thinking and action, this specialization also shapes the profile of the TUMCS for Sustainability and Biotechnology and adds a new component to the portfolio of the Faculty of Business Administration and Economics


# Here's the task you need to perform:
Given the following input information, provide a concise, accurate summary of the customer interactions, aiding support desk personnel in understanding and resolving issues more effectively.
    Original Inquiry: {email}
    Answer: {answer}

Your knowledge field/area of expertise:
Customer service and support, communication analysis, data summarization.

Approach this task step-by-step, take your time and do not skip steps:

Task to be done:
    Read and analyze the extensive input data.
    Identify key issues, concerns, or queries raised by customers.
    Summarize the context and content of the answer, focusing on crucial points.
    Output format: A clear, concise summary, structured in an easy-to-understand manner and including the most important information for forwarding to support desk personnel.